#########
#   #   ##
# $$#$$ @#
#    $  ##
#   # ##############
####  $ #     #....#
   # $$ #$ $ $#....#
   #  $     $ #....#
   # $$$#$  $ #  ..#
   #    #  $ $   ..#
   ############  ..#
              #  ..#
              ######