############
#...#  @#  ##
#...#$$  $  #
#...   ##  $#
#   # ##    ###
#####  $ #$$  #
  # $ $       #
  #   #########
  #####