       #####
      ##   #
      #  $ #####
      # $ $    #
      ### #### ##
 ######## $    @#
##...  ## $$## ##
#....       ## #
##...  #### ## #
 ######## $ $  #
        #  $ $ #
        #      #
        ########