          #########
######## ##   #   #
#...#  ###  $  $  #
#...#    @ # ### ##
#...    # ##  #   #
#  ### $#$  $  $  #
##      # #  ## ###
 #### #$$ ## ##  #
    #   #   $    #
    #####  #  ####
        #######