  ########
  #      #   ######
  #$ $ $ #   #  ..#
###  $  $#####  ..##
#  $$$   $      ...#
# #  $ ####@##  ..##
# #  $ #  ####  ..#
#    ###     ######
######