        ####
        #  #
        #  #
        #  #
     #### ###
     # $    #
###### $$ $ #####
#@ $  $    $  $ #
##   #$ $   #   #
 #####  $ $ #####
     # $$$ ##
     ### ########
      ## ##  ...#
      #  ##  ...#
      #      ...#
      #####  ...#
          #  ...#
          #######