   #######
 ##   #  .#
#   $   #.#
#  $#$  #.#
# $@  ###.#
# $$$# . .#
##     $# #
 ####   ..#
    #######