   #######
  #      .#
##  $  ##.#
#  $#$ ##.#
# $@  #.#.#
# $$$# .$.#
##     $# #
 ####   ..#
    #######