   #######
  #   #  .#
##  $   #.#
#  $#$ ##.#
# $@  #.#.#
#  $$#  $.#
##     $# #
 ####   ..#
    #######