#########
#   @...#
# #$#.*.#
# $  $$ #
## #$   #
 #   ####
 #####