     ####
     #  #####
 #####      #
 #  ## ##   #
##   $   #$$ #
#  ####  # $ #
#  ..##$#    #
###... $ # # #
  #.*.#$ #$  #
  #...#  # $##
  #####$    #
     #@  ####
     #####