   ######
   # @  #
####  $ #
# *..*$ #
# $*..* #
# $  ####
#    #
######