 ##########
##  #     #
#     $...#
# # @ #...#
#    #....#
# $#$$...####
#    ###$   #
##  #    $$$###
 #$ $ ##   $  #
 #  #$#  #    #
 ###  $  ######
   #   # #
   ###   #
     #####