      ######
    ### ...##
   ##   ....##
   # $##$#...#
   # $  @ ...#
 ###  # # # $#
## $ #  #$## #
#    $ $   # ##
# $ # ##   $  #
#  #   ## # # #
# # $$   $    #
#     #  ##  ##
#####   ######
    #####