   ###########
   #   #     #
####   # $ $ #
#  $  $   #$ #
#   $  # $$  #
# #  $$##  # #
# $$    ##   #
#@$  $ $   ###
## ####$##$#
#  #...... ##
#   .....#  #
####......  #
   ##########