#######
#  . ##
# $ $ #
#. * .#
# $ $ #
## . @#
#######