##########
# @###...#
# $$  .$.#
#   #$#$ #
##       #
##########