######
#    ##
# $ * #
##.$$.#
#. @ .#
#.$$.##
# * $ #
##    #
 ######