  ####
  #. # ###
###$ ###.#
#  .$.   #
#   ##$$ #
# $$.#@  #
#  $.#####
###   .#
  ######