       #####
########   #
#.....# $# #
#.....   # #
#...  # $# ###
##### #  #   #
    #   $#$# #
    ###$ $ # ##
      #   $@$ #
      #   # $ #
      #$ $$$  #
      #       #
      #########