   ###########
  ##     #  .#
  #  $#$ #...#
###  $  $#  .#
#  $$$   $ @.#
# #  $ ###  .#
#  $ $ # #...#
#    ### #  .#
######   #####