     ######
######    #
# $ .*. $ #
#@$.* *.$ #
# $ .*. $ #
#     #####
#######