 ####
 #  ######
 #@$  $  ####
 #  #   $#  #
 ## #$ $  ..####
### # ####.....#
#    $ # $.....#
# $    $  #  ###
#### #$#  ####
   # $ $ ##
   #    ##
   ######