    ############
   #......#####
  #@..$ **.###
  #  $ $      #
  ####### #$#  #
 # #  # $ $  $ #
#  #  # #  # # #
      #  #   $ #
       #  $##  #
        #     #
         #####