    #######
    #     ##
    #  $$  #####
   ### #  $#...#
 ### $ #  $ ...#
 #     ## $#...#
 # $ #$    #...#
 # #  $ # $ ...#
 #  $ $##$  #  #
## ##$ #@ ######
# $    ####
#   #  #
########