########
#@     #
# .*$  #
# * .$ #
# *. $ #
# * .$ #
# .*$  #
#      #
########