########
#@     #
# *..$ #
# *$ $ #
# *.$$ #
# *  $ #
# ...  #
#      #
########