########
#@     #
# $..$ #
# .$$. #
# *  * #
# .$$. #
# $..$ #
#      #
########