#####
#...#
# @###
# $  #
# $  #
# $ ##
#  ##
####