#########
#@    .*#
#**$** *#
#*  .* *#
#* $*$ *#
#*.    *#
#*******#
#########
