##   ######
#######. .#
#       * #
#@$$$$#. . #
##    #    #
 #   ##  ###
 ########## 