###############
#.$.$. .$      #
#@$  $.$* * .  # 
# ## ## #######
#       #
#########