#############
# *@*    ***#
#  * *  $ **#
#*  $ $ $  *#
#*..$.*.*.**#
#***********#
#############