######
#    ##
#.$.$@#
#   ###
#  ##
####