 ######## 
#  .   .#
# # $$$ #
#  .# @#
########