 ######
##    #
#+$ # #
#$# $ #
# . .##
#  # #
#    #
#  ####
#### #