     ##
#####.#
#@.#  #
# $  $#
## $*.#
 #   #
  ####