  #####
###  @#
#     #
#    #########
# #  $ ..    #
#  $ ######  #
##  ##    #  #
 ####     ####
 