   ######
####     #
#    @   #
#    $   #
#    .   #
##########
