    #####
   ##   #
 ###    #
##   $ ##
#@. ** #
#    * #
########
