######
#  . #
#  $  #
#* @   #
#  . $ #
#    ###
######
