   ##########
###         #
#    ## $..##
# $$@###$#.##
# # $## $..##
###    $ #.##
  ####     .#
     ########