   ##########
 ##         #
#   ##### # #
# $$$ ... # #
# $@$#.#.   #
# $$$ ... ###
###    ## #
  #####   #
    #######