    #######
   #   ##  ##
###  $    ..#
#   $$$ #..#
# $$@ ##.#.#
# # $$# $ .#
###      #.#
  ####    .#
     #######