    ####
   #   ######
###  $      #
#   $$  $..##
# $$@ ## $.##
# # $## $#.##
###      $..#
  ####  ....#
     ########