  #####  
###. ####
#  *    ##
#  $$$# ###
#### @  ..#
  ########