########
#     ##
# #.#$##
# *@.  #
###*#$ #
#     ##
#    ###
###  ###
########