 #######
#   #@  #
#  .*.  #
# #$$  #
#   ####
#####