#######
#.# $.#
# @$  ###
# $# $  #
##   .# #
 ####.  #
    #####