    ####
 ####  ##
 #      #
 #$***  #
 # * #  #
## *    #
# @*.####
#    #
######
