 ####
##@ #####
#  $$   #
# # # # #
#  ..   #
####   ##
   #####
   