  ####
  #@ ####
###     #
#  $ #  #
# #**$*.#
#     $ #
##..#** #
 #     ##
 #   ### 
 #####
  