#####
#    ##
#     #
#     #
#@$   #
#$.$  #
#..  #
######
