   #####
####   #
# $   .##
#   *   #
##.   $ #
 # @  ###
 #####
 