  #######
###  +  ###
#   #$#   #
# #  *  # #
#  # * #  #
##   #   ##
 #########
 