  ###
##...##
# . . #
#  .  #
##   ##
  # #
##   ##
#  $  #
#  $  #
# $$$ #
#  $  #
## @ ##
  ###