##########
#        #
# $.$$.$ #
#        #
# .    . #
# .    . #
#        #
# $.$$.$ #
#       @#
##########