##########
#        #
# $ $. . #
#  $  .  #
# $#$.#. #
# .#.$#$ #
#  .  $  #
# . .$ $ #
#@       #
##########