##########
#        #
# $#$.#. #
#  $  .  #
# $#$. . #
# . .$#$ #
#  .  $  #
# .#.$#$ #
#@       #
##########