  #####
 #  .  #
# $.$.$ #
# $.$.$ #
#  .@.  #
# $.$.$ #
# $.$.$ #
##  .  #
  #####