##########
#        #
# .$$#$$ #
# . $ .. #
# ###$$$ #
# #..+.# #
#        #
##########