  #######
  ### ###
 #   #   #
#  $ @ $  #
#  # ###  #
#   ...# #
 #$$. .$$#
 # #...#  #
#  ### #  #
#  $   $  #
#    #    #
 #### ####