  ######
  #  @ #
  # $  #
#### $ #
# .#$ ##
#..# $#
#..$  ##
#.. $  #
####$  #
   #   #
   #####