########
#....  ##########
##...    $  $   #
#....  ## $  $  #
######### $ # ###
        ##$ $ #
        # $  $#
        # $#$ ##
        #     @#
        ########