########
#@     #
#  **$ #
# *  . #
# .$$. #
# .  * #
# $**  #
#      #
########