########
#@     #
# . $. #
# .* * #
# .$** #
# .$ * #
#  $ $ #
#      #
########