########
#@     #
# .$$* #
# ..$. #
# . *. #
# . $. #
# $$$$ #
#      #
########