########
#@     #
# $..* #
# .$$  #
# $..$ #
#  $$. #
# *..$ #
#      #
########