##########
#        #
# $#$.#. #
#  $  .  #
# $#$.#. #
# .#.$#$ #
#  .  $  #
# .#.$#$ #
#@       #
##########