###########
#         #
#.......  #
########  #
#    $ $$ #
#         #
###$####  #
#@     $  #
######$ $ #
     #    #
      #####