#############
#           #
# $#$.#.$#$ #
#  $  .  $  #
# $#$.#.$#$ #
# .#.$#$.#. #
#  .  $  .  #
# .#.$#$.#. #
#@          #
#############