    ####
  ##    #
 #    #  #
#  $$$   #
# #$@$## #
#  $$$   #
# #   ###
 # ... #
# .   . #
 # ... #
  #   #
   ###