##########
#        #
# $$$### #
# ..  .# #
# ###$$$ #
# #...@# #
#        #
##########