
        #####
       ##   ##
      # #   #
     ####$ $###
    ##  $...$ ##
   ##    .@.  #
  # #   $...$ ##
  #######$ $###
        #   #
        #####