      #### ###################
  #####  ###            .$   #
###  $.       #####$####   # #
#    $.  #### #     .   ### .#
#  $ $.### ## # #### #  $.# $#
###  $.## # # # #  #  # $ #  #
  ###### # ## #$ $ ##   #. # #
        ##### #.#.  #  ### # #
 #####  #   # ### ###   #    #
 ## ##  #     .#  #   #$$*  ##
 # ### ### ## ## ## #  .#. ##
 ### # #  .$ .# $.$.## ### #
 ## ## # #.####     # $.   ##
 # ### # $$   ### ###   ##  ##
 ### # # #   . $@$  #######. #
 ##### # ### ####.#        $ #
       #     #  ###########  #
       #######            ####